R  1080 720
NO ./textures/brick.xpm
SO ./textures/blue.xpm
WE ./textures/wood.xpm
EA ./textures/grey.xpm

F 146,142,133
C 135,206,235

111111111111111111111111111
111100000011100000000000001
111100000011100000000000101
111100000000000000000001001
111100000011100000000010001
100000000011100000111110001
111101111111110111100001001
111101111111110111010000001
110000000011010111000000001
100000000000000000000000001
100000N00000000001100010001
110000000011010111111110001
111101111110101111111110001
111111111111111111111111111