R  1080 720
NO ./textures/brick.xpm
SO ./textures/blue.xpm
WE ./textures/wood.xpm
EA ./textures/grey.xpm

F 224,172,105
C 205,249,255

     11111111111111111
     10000000000000001
     10000000000000001
     10000000000000001
     11000000000111101
11111111111110001
10000000000000001
10000000111000001
100000001 1000001
10000000111000001
10000000N00000001
10000000000000001
11111111111111111