R  1080 720
NO ./textures/brick.xpm
SO ./textures/blue.xpm
WE ./textures/wood.xpm
EA ./textures/grey.xpm

S ./textures/chalice.xpm
F 224,172,105
C 205,249,255

11111111111111111
10000000000000001
10000000000000001
100000000N0000001
11111111111111111